دِوگونُک	NNP
مَقصَد	NN
چُھ	VAUX
مَہرازٕ	NN
اَدٕ	CC
سُہ	PRP
میکھلہِ	NN
مَہرازٕ	NN
ٲسۍ	VAUX	
تَن	POW
یا	CC
کھانٛدرٕ	NN
مہرازٕ	NN
تہٕ	CC
مہرنینۍ	NN
شرٛان	NN
بیترِ	NN
کرنہٕ	VM
سۭتۍ	PSP
تہٕ	CC
دِوتاہَن	NNP
آواہَن	NN
کرنہٕ	VM
سۭتۍ	PSP
پَوٮ۪تر	JJ
بَناوُن	VM
آسان	VAUX
ـ	SYM