یِم	DEM
لُکھ	NN
غوٚروٗر	NN
تہٕ	CC
تکبُرٕ	NN
خٲطرٕ	PSP
پنُن	PRP
پٲجامہٕ	NN
یا	CC
لوٗنگۍ	NN
لاگہِ	VM
ژٕنٕنٮ۪و	NN
بۄن	RB
چِھ	VAUX
ترٛاوان،	VM
نبیﷺ	NNP
سٕنزَن	PSP
نظرن	NN
منٛز	PSP
چِھ	VAUX
تِم	DEM
لُکھ	NN
ناکام	JJ
تہٕ	CC
نامُراد	JJ
تہٕ	CC
سخت	INTF
عزابٕکۍ	NN
حقدار	NN
۔	SYM
أمِس	PRP
روٗز	VM
فِکٕر	NN
تہٕ	CC
پریشٲنی	NN
دِلَس	NN
تہٕ	CC
دٮ۪ماغَس	NN
أنٛدٕرۍ	RB
أنٛدٕرۍ	RB
ژٕہان	VM
مول	NN
موج	NN
ٲسِس	VAUX
کن	PSP
آسنہٕ	VAUX
سَببہٕ	NN
سخت	INTF
لول	NN
بَران	VM
۔	SYM